[GUM_interview_messina.conllu\Line                   15]:	 Unknown UPOS tag:	 ''	
[GUM_interview_stardust.conllu\Line                   1152]:	 Unknown UPOS tag:	 ''	
[GUM_interview_cyclone.conllu\Line                   700]:	 Unknown UPOS tag:	 $	
[GUM_news_defector.conllu\Line                   165]:	 Unknown UPOS tag:	 $	
[GUM_news_expo.conllu\Line                   432]:	 Unknown UPOS tag:	 $	
[GUM_interview_cocktail.conllu\Line                   407]:	 Unknown UPOS tag:	 (	
[GUM_interview_herrick.conllu\Line                   389]:	 Unknown UPOS tag:	 (	
[GUM_interview_stardust.conllu\Line                   1334]:	 Unknown UPOS tag:	 (	
[GUM_whow_procrastinating.conllu\Line                   750]:	 Unknown UPOS tag:	 (	
[GUM_whow_procrastinating.conllu\Line                   998]:	 Unknown UPOS tag:	 (	
[GUM_news_iodine.conllu\Line                   192]:	 Unknown UPOS tag:	 :	
[GUM_news_warhol.conllu\Line                   503]:	 Unknown UPOS tag:	 :	
[GUM_news_warming.conllu\Line                   65]:	 Unknown UPOS tag:	 :	
[GUM_voyage_fortlee.conllu\Line                   1208]:	 Unknown UPOS tag:	 :	
[GUM_voyage_fortlee.conllu\Line                   1215]:	 Unknown UPOS tag:	 :	
[GUM_voyage_fortlee.conllu\Line                   1222]:	 Unknown UPOS tag:	 :	
[GUM_voyage_guadeloupe.conllu\Line                   771]:	 Unknown UPOS tag:	 :	
[GUM_voyage_guadeloupe.conllu\Line                   787]:	 Unknown UPOS tag:	 :	
[GUM_voyage_merida.conllu\Line                   722]:	 Unknown UPOS tag:	 :	
[GUM_voyage_merida.conllu\Line                   727]:	 Unknown UPOS tag:	 :	
[GUM_voyage_merida.conllu\Line                   767]:	 Unknown UPOS tag:	 :	
[GUM_whow_ballet.conllu\Line                   235]:	 Unknown UPOS tag:	 :	
[GUM_whow_cupcakes.conllu\Line                   263]:	 Unknown UPOS tag:	 :	
[GUM_whow_cupcakes.conllu\Line                   331]:	 Unknown UPOS tag:	 :	
[GUM_whow_cupcakes.conllu\Line                   358]:	 Unknown UPOS tag:	 :	
[GUM_whow_cupcakes.conllu\Line                   374]:	 Unknown UPOS tag:	 :	
[GUM_whow_cupcakes.conllu\Line                   669]:	 Unknown UPOS tag:	 :	
[GUM_whow_skittles.conllu\Line                   466]:	 Unknown UPOS tag:	 :	
[GUM_voyage_merida.conllu\Tree number 31 on line 679]:	 Multiple root words:	" [1, 10, 7]"	
[GUM_interview_chomsky.conllu\Tree number 25 on line 600]:	 Multiple root words:	" [1, 11]"	
[GUM_whow_flirt.conllu\Tree number 14 on line 363]:	 Multiple root words:	" [1, 14]"	
[GUM_whow_procrastinating.conllu\Tree number 27 on line 555]:	 Multiple root words:	" [1, 18]"	
[GUM_voyage_fortlee.conllu\Tree number 50 on line 1109]:	 Multiple root words:	" [1, 3]"	
[GUM_interview_chomsky.conllu\Tree number 43 on line 1191]:	 Multiple root words:	" [1, 5, 15]"	
[GUM_voyage_tulsa.conllu\Tree number 23 on line 469]:	 Multiple root words:	" [1, 5]"	
[GUM_voyage_vavau.conllu\Tree number 10 on line 186]:	 Multiple root words:	" [10, 23]"	
[GUM_interview_herrick.conllu\Tree number 25 on line 494]:	 Multiple root words:	" [10, 3]"	
[GUM_interview_chomsky.conllu\Tree number 28 on line 713]:	 Multiple root words:	" [13, 15]"	
[GUM_whow_procrastinating.conllu\Tree number 5 on line 83]:	 Multiple root words:	" [16, 2, 19]"	
[GUM_voyage_phoenix.conllu\Tree number 3 on line 43]:	 Multiple root words:	" [16, 9, 18, 14, 7]"	
[GUM_whow_procrastinating.conllu\Tree number 14 on line 267]:	 Multiple root words:	" [17, 4]"	
[GUM_whow_elevator.conllu\Tree number 11 on line 211]:	 Multiple root words:	" [17, 6]"	
[GUM_interview_chomsky.conllu\Tree number 27 on line 680]:	 Multiple root words:	" [18, 3]"	
[GUM_voyage_isfahan.conllu\Tree number 39 on line 645]:	 Multiple root words:	" [18, 3]"	
[GUM_whow_procrastinating.conllu\Tree number 25 on line 492]:	 Multiple root words:	" [18, 5]"	
[GUM_voyage_merida.conllu\Tree number 33 on line 734]:	 Multiple root words:	" [2, 4]"	
[GUM_whow_procrastinating.conllu\Tree number 13 on line 250]:	 Multiple root words:	" [2, 4]"	
[GUM_whow_procrastinating.conllu\Tree number 19 on line 364]:	 Multiple root words:	" [2, 7]"	
[GUM_whow_procrastinating.conllu\Tree number 3 on line 37]:	 Multiple root words:	" [20, 13]"	
[GUM_interview_chomsky.conllu\Tree number 36 on line 1030]:	 Multiple root words:	" [24, 3]"	
[GUM_whow_mice.conllu\Tree number 61 on line 1162]:	 Multiple root words:	" [3, 12]"	
[GUM_voyage_tulsa.conllu\Tree number 55 on line 1143]:	 Multiple root words:	" [3, 15]"	
[GUM_whow_parachute.conllu\Tree number 26 on line 466]:	 Multiple root words:	" [3, 19]"	
[GUM_news_clock.conllu\Tree number 28 on line 597]:	 Multiple root words:	" [3, 30]"	
[GUM_news_election.conllu\Tree number 4 on line 62]:	 Multiple root words:	" [3, 30]"	
[GUM_interview_chomsky.conllu\Tree number 33 on line 889]:	 Multiple root words:	" [35, 12, 7]"	
[GUM_interview_shalev.conllu\Tree number 56 on line 1104]:	 Multiple root words:	" [4, 15]"	
[GUM_interview_shalev.conllu\Tree number 5 on line 68]:	 Multiple root words:	" [7, 3, 15]"	
[GUM_interview_dungeon.conllu\Tree number 42 on line 721]:	 Multiple root words:	" [8, 11]"	
[GUM_interview_shalev.conllu\Tree number 28 on line 433]:	 Multiple root words:	" [8, 5]"	
[GUM_news_expo.conllu\Tree number 40 on line 786]:	 Multiple root words:	" [8, 5]"	
[GUM_interview_shalev.conllu\Tree number 57 on line 1127]:	 Multiple root words:	" [9, 4]"	
[GUM_interview_chomsky.conllu\Line                   996]:	 Unknown UPOS tag:	 MD	
[GUM_interview_dungeon.conllu\Line                   950]:	 Unknown UPOS tag:	 MD	
[GUM_interview_dungeon.conllu\Line                   952]:	 Unknown UPOS tag:	 MD	
[GUM_interview_mckenzie.conllu\Line                   575]:	 Unknown UPOS tag:	 MD	
[GUM_interview_peres.conllu\Line                   491]:	 Unknown UPOS tag:	 MD	
[GUM_interview_stardust.conllu\Line                   1149]:	 Unknown UPOS tag:	 MD	
[GUM_news_crane.conllu\Line                   290]:	 Unknown UPOS tag:	 MD	
[GUM_news_iodine.conllu\Line                   767]:	 Unknown UPOS tag:	 MD	
[GUM_whow_arrogant.conllu\Line                   517]:	 Unknown UPOS tag:	 MD	
[GUM_whow_elevator.conllu\Line                   601]:	 Unknown UPOS tag:	 MD	
[GUM_whow_languages.conllu\Line                   996]:	 Unknown UPOS tag:	 MD	
[GUM_whow_languages.conllu\Line                   998]:	 Unknown UPOS tag:	 MD	
[GUM_whow_overalls.conllu\Line                   801]:	 Unknown UPOS tag:	 MD	
[GUM_whow_parachute.conllu\Line                   233]:	 Unknown UPOS tag:	 MD	
[GUM_interview_cyclone.conllu\Line                   1020]:	 Unknown UD DEPREL:	 ncmod	
[GUM_news_expo.conllu\Line                   275]:	 Unknown UD DEPREL:	 ncmod	
[GUM_news_iodine.conllu\Line                   153]:	 Unknown UD DEPREL:	 ncmod	
[GUM_whow_skittles.conllu\Line                   94]:	 Unknown UD DEPREL:	 ncmod	
[GUM_interview_ants.conllu\Line                   241]:	 Unknown UD DEPREL:	 pcomp	
[GUM_interview_onion.conllu\Line                   1495]:	 Unknown UD DEPREL:	 pcomp	
[GUM_interview_peres.conllu\Line                   665]:	 Unknown UD DEPREL:	 pcomp	
[GUM_news_warhol.conllu\Line                   586]:	 Unknown UD DEPREL:	 pcomp	
[GUM_voyage_guadeloupe.conllu\Line                   519]:	 Unknown UD DEPREL:	 pcomp	
[GUM_voyage_guadeloupe.conllu\Line                   675]:	 Unknown UD DEPREL:	 pcomp	
[GUM_voyage_isfahan.conllu\Line                   1241]:	 Unknown UD DEPREL:	 pcomp	
[GUM_voyage_york.conllu\Line                   733]:	 Unknown UD DEPREL:	 pcomp	
[GUM_whow_basil.conllu\Line                   69]:	 Unknown UD DEPREL:	 pcomp	
[GUM_whow_cactus.conllu\Line                   280]:	 Unknown UD DEPREL:	 pcomp	
[GUM_whow_chicken.conllu\Line                   413]:	 Unknown UD DEPREL:	 pcomp	
[GUM_whow_quidditch.conllu\Line                   462]:	 Unknown UD DEPREL:	 pcomp	
[GUM_whow_quinoa.conllu\Line                   377]:	 Unknown UD DEPREL:	 pcomp	
[GUM_interview_ants.conllu\Line                   998]:	 Unknown UD DEPREL:	 pobj	
[GUM_interview_chomsky.conllu\Line                   12]:	 Unknown UD DEPREL:	 pobj	
[GUM_interview_chomsky.conllu\Line                   131]:	 Unknown UD DEPREL:	 pobj	
[GUM_interview_chomsky.conllu\Line                   134]:	 Unknown UD DEPREL:	 pobj	
[GUM_interview_chomsky.conllu\Line                   180]:	 Unknown UD DEPREL:	 pobj	
[GUM_interview_chomsky.conllu\Line                   496]:	 Unknown UD DEPREL:	 pobj	
[GUM_interview_cocktail.conllu\Line                   864]:	 Unknown UD DEPREL:	 pobj	
[GUM_interview_cyclone.conllu\Line                   1030]:	 Unknown UD DEPREL:	 pobj	
[GUM_interview_cyclone.conllu\Line                   467]:	 Unknown UD DEPREL:	 pobj	
[GUM_interview_cyclone.conllu\Line                   671]:	 Unknown UD DEPREL:	 pobj	
[GUM_interview_cyclone.conllu\Line                   777]:	 Unknown UD DEPREL:	 pobj	
[GUM_interview_daly.conllu\Line                   1129]:	 Unknown UD DEPREL:	 pobj	
[GUM_interview_dungeon.conllu\Line                   1366]:	 Unknown UD DEPREL:	 pobj	
[GUM_interview_dungeon.conllu\Line                   379]:	 Unknown UD DEPREL:	 pobj	
[GUM_interview_dungeon.conllu\Line                   612]:	 Unknown UD DEPREL:	 pobj	
[GUM_interview_dungeon.conllu\Line                   625]:	 Unknown UD DEPREL:	 pobj	
[GUM_interview_dungeon.conllu\Line                   662]:	 Unknown UD DEPREL:	 pobj	
[GUM_interview_gaming.conllu\Line                   253]:	 Unknown UD DEPREL:	 pobj	
[GUM_interview_gaming.conllu\Line                   839]:	 Unknown UD DEPREL:	 pobj	
[GUM_interview_herrick.conllu\Line                   1474]:	 Unknown UD DEPREL:	 pobj	
[GUM_interview_herrick.conllu\Line                   382]:	 Unknown UD DEPREL:	 pobj	
[GUM_interview_herrick.conllu\Line                   437]:	 Unknown UD DEPREL:	 pobj	
[GUM_interview_herrick.conllu\Line                   483]:	 Unknown UD DEPREL:	 pobj	
[GUM_interview_herrick.conllu\Line                   603]:	 Unknown UD DEPREL:	 pobj	
[GUM_interview_libertarian.conllu\Line                   608]:	 Unknown UD DEPREL:	 pobj	
[GUM_interview_licen.conllu\Line                   193]:	 Unknown UD DEPREL:	 pobj	
[GUM_interview_licen.conllu\Line                   329]:	 Unknown UD DEPREL:	 pobj	
[GUM_interview_licen.conllu\Line                   773]:	 Unknown UD DEPREL:	 pobj	
[GUM_interview_mcguire.conllu\Line                   314]:	 Unknown UD DEPREL:	 pobj	
[GUM_interview_mcguire.conllu\Line                   318]:	 Unknown UD DEPREL:	 pobj	
[GUM_interview_mcguire.conllu\Line                   322]:	 Unknown UD DEPREL:	 pobj	
[GUM_interview_mcguire.conllu\Line                   719]:	 Unknown UD DEPREL:	 pobj	
[GUM_interview_messina.conllu\Line                   188]:	 Unknown UD DEPREL:	 pobj	
[GUM_interview_messina.conllu\Line                   238]:	 Unknown UD DEPREL:	 pobj	
[GUM_interview_messina.conllu\Line                   373]:	 Unknown UD DEPREL:	 pobj	
[GUM_interview_messina.conllu\Line                   431]:	 Unknown UD DEPREL:	 pobj	
[GUM_interview_onion.conllu\Line                   1493]:	 Unknown UD DEPREL:	 pobj	
[GUM_interview_onion.conllu\Line                   476]:	 Unknown UD DEPREL:	 pobj	
[GUM_interview_onion.conllu\Line                   636]:	 Unknown UD DEPREL:	 pobj	
[GUM_interview_shalev.conllu\Line                   230]:	 Unknown UD DEPREL:	 pobj	
[GUM_interview_stardust.conllu\Line                   16]:	 Unknown UD DEPREL:	 pobj	
[GUM_interview_stardust.conllu\Line                   400]:	 Unknown UD DEPREL:	 pobj	
[GUM_interview_stardust.conllu\Line                   623]:	 Unknown UD DEPREL:	 pobj	
[GUM_news_asylum.conllu\Line                   140]:	 Unknown UD DEPREL:	 pobj	
[GUM_news_asylum.conllu\Line                   193]:	 Unknown UD DEPREL:	 pobj	
[GUM_news_crane.conllu\Line                   6]:	 Unknown UD DEPREL:	 pobj	
[GUM_news_crane.conllu\Line                   68]:	 Unknown UD DEPREL:	 pobj	
[GUM_news_defector.conllu\Line                   402]:	 Unknown UD DEPREL:	 pobj	
[GUM_news_defector.conllu\Line                   594]:	 Unknown UD DEPREL:	 pobj	
[GUM_news_hackers.conllu\Line                   159]:	 Unknown UD DEPREL:	 pobj	
[GUM_news_hackers.conllu\Line                   293]:	 Unknown UD DEPREL:	 pobj	
[GUM_news_hackers.conllu\Line                   409]:	 Unknown UD DEPREL:	 pobj	
[GUM_news_hackers.conllu\Line                   674]:	 Unknown UD DEPREL:	 pobj	
[GUM_news_homeopathic.conllu\Line                   236]:	 Unknown UD DEPREL:	 pobj	
[GUM_news_homeopathic.conllu\Line                   337]:	 Unknown UD DEPREL:	 pobj	
[GUM_news_homeopathic.conllu\Line                   547]:	 Unknown UD DEPREL:	 pobj	
[GUM_news_homeopathic.conllu\Line                   555]:	 Unknown UD DEPREL:	 pobj	
[GUM_news_imprisoned.conllu\Line                   347]:	 Unknown UD DEPREL:	 pobj	
[GUM_news_iodine.conllu\Line                   514]:	 Unknown UD DEPREL:	 pobj	
[GUM_news_korea.conllu\Line                   33]:	 Unknown UD DEPREL:	 pobj	
[GUM_news_korea.conllu\Line                   365]:	 Unknown UD DEPREL:	 pobj	
[GUM_news_lanterns.conllu\Line                   238]:	 Unknown UD DEPREL:	 pobj	
[GUM_news_lanterns.conllu\Line                   342]:	 Unknown UD DEPREL:	 pobj	
[GUM_news_lanterns.conllu\Line                   644]:	 Unknown UD DEPREL:	 pobj	
[GUM_news_sensitive.conllu\Line                   71]:	 Unknown UD DEPREL:	 pobj	
[GUM_news_sensitive.conllu\Line                   73]:	 Unknown UD DEPREL:	 pobj	
[GUM_news_stampede.conllu\Line                   269]:	 Unknown UD DEPREL:	 pobj	
[GUM_news_stampede.conllu\Line                   40]:	 Unknown UD DEPREL:	 pobj	
[GUM_news_taxes.conllu\Line                   184]:	 Unknown UD DEPREL:	 pobj	
[GUM_news_taxes.conllu\Line                   291]:	 Unknown UD DEPREL:	 pobj	
[GUM_news_warhol.conllu\Line                   1480]:	 Unknown UD DEPREL:	 pobj	
[GUM_news_warhol.conllu\Line                   1545]:	 Unknown UD DEPREL:	 pobj	
[GUM_news_warhol.conllu\Line                   333]:	 Unknown UD DEPREL:	 pobj	
[GUM_news_warhol.conllu\Line                   367]:	 Unknown UD DEPREL:	 pobj	
[GUM_news_warhol.conllu\Line                   774]:	 Unknown UD DEPREL:	 pobj	
[GUM_news_warming.conllu\Line                   135]:	 Unknown UD DEPREL:	 pobj	
[GUM_news_warming.conllu\Line                   238]:	 Unknown UD DEPREL:	 pobj	
[GUM_news_warming.conllu\Line                   290]:	 Unknown UD DEPREL:	 pobj	
[GUM_news_warming.conllu\Line                   396]:	 Unknown UD DEPREL:	 pobj	
[GUM_news_warming.conllu\Line                   414]:	 Unknown UD DEPREL:	 pobj	
[GUM_news_warming.conllu\Line                   514]:	 Unknown UD DEPREL:	 pobj	
[GUM_news_worship.conllu\Line                   130]:	 Unknown UD DEPREL:	 pobj	
[GUM_news_worship.conllu\Line                   167]:	 Unknown UD DEPREL:	 pobj	
[GUM_news_worship.conllu\Line                   83]:	 Unknown UD DEPREL:	 pobj	
[GUM_voyage_athens.conllu\Line                   876]:	 Unknown UD DEPREL:	 pobj	
[GUM_voyage_chatham.conllu\Line                   267]:	 Unknown UD DEPREL:	 pobj	
[GUM_voyage_chatham.conllu\Line                   432]:	 Unknown UD DEPREL:	 pobj	
[GUM_voyage_chatham.conllu\Line                   559]:	 Unknown UD DEPREL:	 pobj	
[GUM_voyage_cleveland.conllu\Line                   98]:	 Unknown UD DEPREL:	 pobj	
[GUM_voyage_coron.conllu\Line                   310]:	 Unknown UD DEPREL:	 pobj	
[GUM_voyage_cuba.conllu\Line                   213]:	 Unknown UD DEPREL:	 pobj	
[GUM_voyage_cuba.conllu\Line                   235]:	 Unknown UD DEPREL:	 pobj	
[GUM_voyage_cuba.conllu\Line                   793]:	 Unknown UD DEPREL:	 pobj	
[GUM_voyage_cuba.conllu\Line                   796]:	 Unknown UD DEPREL:	 pobj	
[GUM_voyage_cuba.conllu\Line                   931]:	 Unknown UD DEPREL:	 pobj	
[GUM_voyage_fortlee.conllu\Line                   1245]:	 Unknown UD DEPREL:	 pobj	
[GUM_voyage_fortlee.conllu\Line                   356]:	 Unknown UD DEPREL:	 pobj	
[GUM_voyage_fortlee.conllu\Line                   398]:	 Unknown UD DEPREL:	 pobj	
[GUM_voyage_fortlee.conllu\Line                   438]:	 Unknown UD DEPREL:	 pobj	
[GUM_voyage_fortlee.conllu\Line                   468]:	 Unknown UD DEPREL:	 pobj	
[GUM_voyage_fortlee.conllu\Line                   551]:	 Unknown UD DEPREL:	 pobj	
[GUM_voyage_guadeloupe.conllu\Line                   132]:	 Unknown UD DEPREL:	 pobj	
[GUM_voyage_guadeloupe.conllu\Line                   785]:	 Unknown UD DEPREL:	 pobj	
[GUM_voyage_isfahan.conllu\Line                   326]:	 Unknown UD DEPREL:	 pobj	
[GUM_voyage_lodz.conllu\Line                   612]:	 Unknown UD DEPREL:	 pobj	
[GUM_voyage_merida.conllu\Line                   630]:	 Unknown UD DEPREL:	 pobj	
[GUM_voyage_oakland.conllu\Line                   1225]:	 Unknown UD DEPREL:	 pobj	
[GUM_voyage_phoenix.conllu\Line                   1051]:	 Unknown UD DEPREL:	 pobj	
[GUM_voyage_phoenix.conllu\Line                   131]:	 Unknown UD DEPREL:	 pobj	
[GUM_voyage_phoenix.conllu\Line                   592]:	 Unknown UD DEPREL:	 pobj	
[GUM_voyage_phoenix.conllu\Line                   807]:	 Unknown UD DEPREL:	 pobj	
[GUM_voyage_phoenix.conllu\Line                   993]:	 Unknown UD DEPREL:	 pobj	
[GUM_voyage_socotra.conllu\Line                   14]:	 Unknown UD DEPREL:	 pobj	
[GUM_voyage_socotra.conllu\Line                   645]:	 Unknown UD DEPREL:	 pobj	
[GUM_voyage_socotra.conllu\Line                   868]:	 Unknown UD DEPREL:	 pobj	
[GUM_voyage_thailand.conllu\Line                   416]:	 Unknown UD DEPREL:	 pobj	
[GUM_voyage_thailand.conllu\Line                   716]:	 Unknown UD DEPREL:	 pobj	
[GUM_voyage_thailand.conllu\Line                   869]:	 Unknown UD DEPREL:	 pobj	
[GUM_voyage_tulsa.conllu\Line                   1283]:	 Unknown UD DEPREL:	 pobj	
[GUM_voyage_tulsa.conllu\Line                   1406]:	 Unknown UD DEPREL:	 pobj	
[GUM_voyage_tulsa.conllu\Line                   374]:	 Unknown UD DEPREL:	 pobj	
[GUM_voyage_tulsa.conllu\Line                   505]:	 Unknown UD DEPREL:	 pobj	
[GUM_voyage_tulsa.conllu\Line                   524]:	 Unknown UD DEPREL:	 pobj	
[GUM_voyage_tulsa.conllu\Line                   734]:	 Unknown UD DEPREL:	 pobj	
[GUM_voyage_tulsa.conllu\Line                   814]:	 Unknown UD DEPREL:	 pobj	
[GUM_voyage_tulsa.conllu\Line                   853]:	 Unknown UD DEPREL:	 pobj	
[GUM_voyage_tulsa.conllu\Line                   973]:	 Unknown UD DEPREL:	 pobj	
[GUM_voyage_york.conllu\Line                   25]:	 Unknown UD DEPREL:	 pobj	
[GUM_voyage_york.conllu\Line                   459]:	 Unknown UD DEPREL:	 pobj	
[GUM_whow_arrogant.conllu\Line                   1009]:	 Unknown UD DEPREL:	 pobj	
[GUM_whow_arrogant.conllu\Line                   119]:	 Unknown UD DEPREL:	 pobj	
[GUM_whow_arrogant.conllu\Line                   325]:	 Unknown UD DEPREL:	 pobj	
[GUM_whow_ballet.conllu\Line                   214]:	 Unknown UD DEPREL:	 pobj	
[GUM_whow_ballet.conllu\Line                   233]:	 Unknown UD DEPREL:	 pobj	
[GUM_whow_basil.conllu\Line                   754]:	 Unknown UD DEPREL:	 pobj	
[GUM_whow_cactus.conllu\Line                   141]:	 Unknown UD DEPREL:	 pobj	
[GUM_whow_cactus.conllu\Line                   315]:	 Unknown UD DEPREL:	 pobj	
[GUM_whow_chicken.conllu\Line                   784]:	 Unknown UD DEPREL:	 pobj	
[GUM_whow_elevator.conllu\Line                   366]:	 Unknown UD DEPREL:	 pobj	
[GUM_whow_elevator.conllu\Line                   96]:	 Unknown UD DEPREL:	 pobj	
[GUM_whow_flirt.conllu\Line                   364]:	 Unknown UD DEPREL:	 pobj	
[GUM_whow_flirt.conllu\Line                   664]:	 Unknown UD DEPREL:	 pobj	
[GUM_whow_flirt.conllu\Line                   840]:	 Unknown UD DEPREL:	 pobj	
[GUM_whow_glowstick.conllu\Line                   806]:	 Unknown UD DEPREL:	 pobj	
[GUM_whow_glowstick.conllu\Line                   826]:	 Unknown UD DEPREL:	 pobj	
[GUM_whow_joke.conllu\Line                   1091]:	 Unknown UD DEPREL:	 pobj	
[GUM_whow_joke.conllu\Line                   488]:	 Unknown UD DEPREL:	 pobj	
[GUM_whow_languages.conllu\Line                   176]:	 Unknown UD DEPREL:	 pobj	
[GUM_whow_languages.conllu\Line                   197]:	 Unknown UD DEPREL:	 pobj	
[GUM_whow_languages.conllu\Line                   98]:	 Unknown UD DEPREL:	 pobj	
[GUM_whow_mice.conllu\Line                   1046]:	 Unknown UD DEPREL:	 pobj	
[GUM_whow_mice.conllu\Line                   690]:	 Unknown UD DEPREL:	 pobj	
[GUM_whow_mice.conllu\Line                   879]:	 Unknown UD DEPREL:	 pobj	
[GUM_whow_overalls.conllu\Line                   587]:	 Unknown UD DEPREL:	 pobj	
[GUM_whow_packing.conllu\Line                   121]:	 Unknown UD DEPREL:	 pobj	
[GUM_whow_packing.conllu\Line                   572]:	 Unknown UD DEPREL:	 pobj	
[GUM_whow_packing.conllu\Line                   852]:	 Unknown UD DEPREL:	 pobj	
[GUM_whow_parachute.conllu\Line                   454]:	 Unknown UD DEPREL:	 pobj	
[GUM_whow_procrastinating.conllu\Line                   1099]:	 Unknown UD DEPREL:	 pobj	
[GUM_whow_procrastinating.conllu\Line                   308]:	 Unknown UD DEPREL:	 pobj	
[GUM_whow_quidditch.conllu\Line                   131]:	 Unknown UD DEPREL:	 pobj	
[GUM_whow_quidditch.conllu\Line                   443]:	 Unknown UD DEPREL:	 pobj	
[GUM_whow_quidditch.conllu\Line                   527]:	 Unknown UD DEPREL:	 pobj	
[GUM_whow_quidditch.conllu\Line                   547]:	 Unknown UD DEPREL:	 pobj	
[GUM_whow_quinoa.conllu\Line                   584]:	 Unknown UD DEPREL:	 pobj	
[GUM_whow_skittles.conllu\Line                   520]:	 Unknown UD DEPREL:	 pobj	
[GUM_interview_chomsky.conllu\Line                   847]:	 Unknown UPOS tag:	 POS	
[GUM_interview_cocktail.conllu\Line                   487]:	 Unknown UPOS tag:	 POS	
[GUM_interview_cocktail.conllu\Line                   567]:	 Unknown UPOS tag:	 POS	
[GUM_interview_cocktail.conllu\Line                   68]:	 Unknown UPOS tag:	 POS	
[GUM_interview_cocktail.conllu\Line                   849]:	 Unknown UPOS tag:	 POS	
[GUM_interview_cocktail.conllu\Line                   91]:	 Unknown UPOS tag:	 POS	
[GUM_interview_cocktail.conllu\Line                   984]:	 Unknown UPOS tag:	 POS	
[GUM_interview_cyclone.conllu\Line                   482]:	 Unknown UPOS tag:	 POS	
[GUM_interview_daly.conllu\Line                   1384]:	 Unknown UPOS tag:	 POS	
[GUM_interview_daly.conllu\Line                   792]:	 Unknown UPOS tag:	 POS	
[GUM_interview_gaming.conllu\Line                   166]:	 Unknown UPOS tag:	 POS	
[GUM_interview_herrick.conllu\Line                   1031]:	 Unknown UPOS tag:	 POS	
[GUM_interview_herrick.conllu\Line                   1054]:	 Unknown UPOS tag:	 POS	
[GUM_interview_herrick.conllu\Line                   1359]:	 Unknown UPOS tag:	 POS	
[GUM_interview_herrick.conllu\Line                   201]:	 Unknown UPOS tag:	 POS	
[GUM_interview_herrick.conllu\Line                   51]:	 Unknown UPOS tag:	 POS	
[GUM_interview_herrick.conllu\Line                   87]:	 Unknown UPOS tag:	 POS	
[GUM_interview_libertarian.conllu\Line                   115]:	 Unknown UPOS tag:	 POS	
[GUM_interview_libertarian.conllu\Line                   184]:	 Unknown UPOS tag:	 POS	
[GUM_interview_libertarian.conllu\Line                   204]:	 Unknown UPOS tag:	 POS	
[GUM_interview_libertarian.conllu\Line                   223]:	 Unknown UPOS tag:	 POS	
[GUM_interview_libertarian.conllu\Line                   38]:	 Unknown UPOS tag:	 POS	
[GUM_interview_licen.conllu\Line                   526]:	 Unknown UPOS tag:	 POS	
[GUM_interview_mcguire.conllu\Line                   1104]:	 Unknown UPOS tag:	 POS	
[GUM_interview_mcguire.conllu\Line                   147]:	 Unknown UPOS tag:	 POS	
[GUM_interview_mcguire.conllu\Line                   188]:	 Unknown UPOS tag:	 POS	
[GUM_interview_mcguire.conllu\Line                   478]:	 Unknown UPOS tag:	 POS	
[GUM_interview_mcguire.conllu\Line                   695]:	 Unknown UPOS tag:	 POS	
[GUM_interview_mckenzie.conllu\Line                   39]:	 Unknown UPOS tag:	 POS	
[GUM_interview_messina.conllu\Line                   749]:	 Unknown UPOS tag:	 POS	
[GUM_interview_onion.conllu\Line                   13]:	 Unknown UPOS tag:	 POS	
[GUM_interview_onion.conllu\Line                   389]:	 Unknown UPOS tag:	 POS	
[GUM_interview_onion.conllu\Line                   556]:	 Unknown UPOS tag:	 POS	
[GUM_interview_onion.conllu\Line                   584]:	 Unknown UPOS tag:	 POS	
[GUM_interview_peres.conllu\Line                   1009]:	 Unknown UPOS tag:	 POS	
[GUM_interview_peres.conllu\Line                   1054]:	 Unknown UPOS tag:	 POS	
[GUM_interview_peres.conllu\Line                   1060]:	 Unknown UPOS tag:	 POS	
[GUM_interview_shalev.conllu\Line                   58]:	 Unknown UPOS tag:	 POS	
[GUM_interview_stardust.conllu\Line                   152]:	 Unknown UPOS tag:	 POS	
[GUM_interview_stardust.conllu\Line                   223]:	 Unknown UPOS tag:	 POS	
[GUM_news_asylum.conllu\Line                   129]:	 Unknown UPOS tag:	 POS	
[GUM_news_asylum.conllu\Line                   252]:	 Unknown UPOS tag:	 POS	
[GUM_news_asylum.conllu\Line                   328]:	 Unknown UPOS tag:	 POS	
[GUM_news_clock.conllu\Line                   33]:	 Unknown UPOS tag:	 POS	
[GUM_news_clock.conllu\Line                   373]:	 Unknown UPOS tag:	 POS	
[GUM_news_clock.conllu\Line                   790]:	 Unknown UPOS tag:	 POS	
[GUM_news_crane.conllu\Line                   264]:	 Unknown UPOS tag:	 POS	
[GUM_news_crane.conllu\Line                   30]:	 Unknown UPOS tag:	 POS	
[GUM_news_crane.conllu\Line                   333]:	 Unknown UPOS tag:	 POS	
[GUM_news_crane.conllu\Line                   50]:	 Unknown UPOS tag:	 POS	
[GUM_news_crane.conllu\Line                   66]:	 Unknown UPOS tag:	 POS	
[GUM_news_defector.conllu\Line                   603]:	 Unknown UPOS tag:	 POS	
[GUM_news_defector.conllu\Line                   716]:	 Unknown UPOS tag:	 POS	
[GUM_news_defector.conllu\Line                   771]:	 Unknown UPOS tag:	 POS	
[GUM_news_defector.conllu\Line                   830]:	 Unknown UPOS tag:	 POS	
[GUM_news_election.conllu\Line                   199]:	 Unknown UPOS tag:	 POS	
[GUM_news_election.conllu\Line                   208]:	 Unknown UPOS tag:	 POS	
[GUM_news_election.conllu\Line                   236]:	 Unknown UPOS tag:	 POS	
[GUM_news_election.conllu\Line                   241]:	 Unknown UPOS tag:	 POS	
[GUM_news_election.conllu\Line                   249]:	 Unknown UPOS tag:	 POS	
[GUM_news_election.conllu\Line                   308]:	 Unknown UPOS tag:	 POS	
[GUM_news_election.conllu\Line                   370]:	 Unknown UPOS tag:	 POS	
[GUM_news_election.conllu\Line                   425]:	 Unknown UPOS tag:	 POS	
[GUM_news_election.conllu\Line                   477]:	 Unknown UPOS tag:	 POS	
[GUM_news_election.conllu\Line                   496]:	 Unknown UPOS tag:	 POS	
[GUM_news_election.conllu\Line                   514]:	 Unknown UPOS tag:	 POS	
[GUM_news_election.conllu\Line                   519]:	 Unknown UPOS tag:	 POS	
[GUM_news_election.conllu\Line                   528]:	 Unknown UPOS tag:	 POS	
[GUM_news_election.conllu\Line                   555]:	 Unknown UPOS tag:	 POS	
[GUM_news_election.conllu\Line                   700]:	 Unknown UPOS tag:	 POS	
[GUM_news_election.conllu\Line                   76]:	 Unknown UPOS tag:	 POS	
[GUM_news_election.conllu\Line                   814]:	 Unknown UPOS tag:	 POS	
[GUM_news_election.conllu\Line                   832]:	 Unknown UPOS tag:	 POS	
[GUM_news_election.conllu\Line                   84]:	 Unknown UPOS tag:	 POS	
[GUM_news_expo.conllu\Line                   225]:	 Unknown UPOS tag:	 POS	
[GUM_news_expo.conllu\Line                   306]:	 Unknown UPOS tag:	 POS	
[GUM_news_expo.conllu\Line                   905]:	 Unknown UPOS tag:	 POS	
[GUM_news_flag.conllu\Line                   118]:	 Unknown UPOS tag:	 POS	
[GUM_news_flag.conllu\Line                   171]:	 Unknown UPOS tag:	 POS	
[GUM_news_flag.conllu\Line                   179]:	 Unknown UPOS tag:	 POS	
[GUM_news_flag.conllu\Line                   286]:	 Unknown UPOS tag:	 POS	
[GUM_news_flag.conllu\Line                   297]:	 Unknown UPOS tag:	 POS	
[GUM_news_flag.conllu\Line                   95]:	 Unknown UPOS tag:	 POS	
[GUM_news_hackers.conllu\Line                   120]:	 Unknown UPOS tag:	 POS	
[GUM_news_hackers.conllu\Line                   147]:	 Unknown UPOS tag:	 POS	
[GUM_news_hackers.conllu\Line                   226]:	 Unknown UPOS tag:	 POS	
[GUM_news_hackers.conllu\Line                   45]:	 Unknown UPOS tag:	 POS	
[GUM_news_hackers.conllu\Line                   535]:	 Unknown UPOS tag:	 POS	
[GUM_news_hackers.conllu\Line                   555]:	 Unknown UPOS tag:	 POS	
[GUM_news_hackers.conllu\Line                   787]:	 Unknown UPOS tag:	 POS	
[GUM_news_homeopathic.conllu\Line                   13]:	 Unknown UPOS tag:	 POS	
[GUM_news_homeopathic.conllu\Line                   193]:	 Unknown UPOS tag:	 POS	
[GUM_news_homeopathic.conllu\Line                   239]:	 Unknown UPOS tag:	 POS	
[GUM_news_homeopathic.conllu\Line                   304]:	 Unknown UPOS tag:	 POS	
[GUM_news_homeopathic.conllu\Line                   344]:	 Unknown UPOS tag:	 POS	
[GUM_news_homeopathic.conllu\Line                   384]:	 Unknown UPOS tag:	 POS	
[GUM_news_homeopathic.conllu\Line                   450]:	 Unknown UPOS tag:	 POS	
[GUM_news_homeopathic.conllu\Line                   587]:	 Unknown UPOS tag:	 POS	
[GUM_news_ie9.conllu\Line                   200]:	 Unknown UPOS tag:	 POS	
[GUM_news_ie9.conllu\Line                   211]:	 Unknown UPOS tag:	 POS	
[GUM_news_ie9.conllu\Line                   269]:	 Unknown UPOS tag:	 POS	
[GUM_news_ie9.conllu\Line                   31]:	 Unknown UPOS tag:	 POS	
[GUM_news_ie9.conllu\Line                   418]:	 Unknown UPOS tag:	 POS	
[GUM_news_ie9.conllu\Line                   508]:	 Unknown UPOS tag:	 POS	
[GUM_news_imprisoned.conllu\Line                   107]:	 Unknown UPOS tag:	 POS	
[GUM_news_imprisoned.conllu\Line                   280]:	 Unknown UPOS tag:	 POS	
[GUM_news_imprisoned.conllu\Line                   398]:	 Unknown UPOS tag:	 POS	
[GUM_news_imprisoned.conllu\Line                   70]:	 Unknown UPOS tag:	 POS	
[GUM_news_iodine.conllu\Line                   1187]:	 Unknown UPOS tag:	 POS	
[GUM_news_iodine.conllu\Line                   82]:	 Unknown UPOS tag:	 POS	
[GUM_news_iodine.conllu\Line                   875]:	 Unknown UPOS tag:	 POS	
[GUM_news_korea.conllu\Line                   225]:	 Unknown UPOS tag:	 POS	
[GUM_news_korea.conllu\Line                   291]:	 Unknown UPOS tag:	 POS	
[GUM_news_korea.conllu\Line                   326]:	 Unknown UPOS tag:	 POS	
[GUM_news_korea.conllu\Line                   38]:	 Unknown UPOS tag:	 POS	
[GUM_news_korea.conllu\Line                   52]:	 Unknown UPOS tag:	 POS	
[GUM_news_nasa.conllu\Line                   1222]:	 Unknown UPOS tag:	 POS	
[GUM_news_nasa.conllu\Line                   1258]:	 Unknown UPOS tag:	 POS	
[GUM_news_nasa.conllu\Line                   1311]:	 Unknown UPOS tag:	 POS	
[GUM_news_nasa.conllu\Line                   243]:	 Unknown UPOS tag:	 POS	
[GUM_news_nasa.conllu\Line                   427]:	 Unknown UPOS tag:	 POS	
[GUM_news_nasa.conllu\Line                   577]:	 Unknown UPOS tag:	 POS	
[GUM_news_nasa.conllu\Line                   663]:	 Unknown UPOS tag:	 POS	
[GUM_news_nasa.conllu\Line                   770]:	 Unknown UPOS tag:	 POS	
[GUM_news_nasa.conllu\Line                   837]:	 Unknown UPOS tag:	 POS	
[GUM_news_nasa.conllu\Line                   873]:	 Unknown UPOS tag:	 POS	
[GUM_news_nasa.conllu\Line                   909]:	 Unknown UPOS tag:	 POS	
[GUM_news_sensitive.conllu\Line                   417]:	 Unknown UPOS tag:	 POS	
[GUM_news_sensitive.conllu\Line                   551]:	 Unknown UPOS tag:	 POS	
[GUM_news_stampede.conllu\Line                   72]:	 Unknown UPOS tag:	 POS	
[GUM_news_taxes.conllu\Line                   690]:	 Unknown UPOS tag:	 POS	
[GUM_news_warhol.conllu\Line                   1033]:	 Unknown UPOS tag:	 POS	
[GUM_news_warhol.conllu\Line                   1177]:	 Unknown UPOS tag:	 POS	
[GUM_news_warhol.conllu\Line                   1218]:	 Unknown UPOS tag:	 POS	
[GUM_news_warhol.conllu\Line                   1353]:	 Unknown UPOS tag:	 POS	
[GUM_news_warhol.conllu\Line                   148]:	 Unknown UPOS tag:	 POS	
[GUM_news_warhol.conllu\Line                   1515]:	 Unknown UPOS tag:	 POS	
[GUM_news_warhol.conllu\Line                   1529]:	 Unknown UPOS tag:	 POS	
[GUM_news_warhol.conllu\Line                   182]:	 Unknown UPOS tag:	 POS	
[GUM_news_warhol.conllu\Line                   222]:	 Unknown UPOS tag:	 POS	
[GUM_news_warhol.conllu\Line                   239]:	 Unknown UPOS tag:	 POS	
[GUM_news_warhol.conllu\Line                   440]:	 Unknown UPOS tag:	 POS	
[GUM_news_warhol.conllu\Line                   456]:	 Unknown UPOS tag:	 POS	
[GUM_news_warhol.conllu\Line                   572]:	 Unknown UPOS tag:	 POS	
[GUM_news_warhol.conllu\Line                   6]:	 Unknown UPOS tag:	 POS	
[GUM_news_warhol.conllu\Line                   878]:	 Unknown UPOS tag:	 POS	
[GUM_news_warhol.conllu\Line                   925]:	 Unknown UPOS tag:	 POS	
[GUM_news_warhol.conllu\Line                   938]:	 Unknown UPOS tag:	 POS	
[GUM_voyage_athens.conllu\Line                   1155]:	 Unknown UPOS tag:	 POS	
[GUM_voyage_athens.conllu\Line                   415]:	 Unknown UPOS tag:	 POS	
[GUM_voyage_athens.conllu\Line                   431]:	 Unknown UPOS tag:	 POS	
[GUM_voyage_athens.conllu\Line                   445]:	 Unknown UPOS tag:	 POS	
[GUM_voyage_athens.conllu\Line                   562]:	 Unknown UPOS tag:	 POS	
[GUM_voyage_athens.conllu\Line                   651]:	 Unknown UPOS tag:	 POS	
[GUM_voyage_athens.conllu\Line                   688]:	 Unknown UPOS tag:	 POS	
[GUM_voyage_athens.conllu\Line                   820]:	 Unknown UPOS tag:	 POS	
[GUM_voyage_athens.conllu\Line                   854]:	 Unknown UPOS tag:	 POS	
[GUM_voyage_athens.conllu\Line                   872]:	 Unknown UPOS tag:	 POS	
[GUM_voyage_athens.conllu\Line                   931]:	 Unknown UPOS tag:	 POS	
[GUM_voyage_athens.conllu\Line                   945]:	 Unknown UPOS tag:	 POS	
[GUM_voyage_athens.conllu\Line                   961]:	 Unknown UPOS tag:	 POS	
[GUM_voyage_chatham.conllu\Line                   1349]:	 Unknown UPOS tag:	 POS	
[GUM_voyage_chatham.conllu\Line                   822]:	 Unknown UPOS tag:	 POS	
[GUM_voyage_chatham.conllu\Line                   998]:	 Unknown UPOS tag:	 POS	
[GUM_voyage_cleveland.conllu\Line                   461]:	 Unknown UPOS tag:	 POS	
[GUM_voyage_cleveland.conllu\Line                   573]:	 Unknown UPOS tag:	 POS	
[GUM_voyage_fortlee.conllu\Line                   1158]:	 Unknown UPOS tag:	 POS	
[GUM_voyage_fortlee.conllu\Line                   1188]:	 Unknown UPOS tag:	 POS	
[GUM_voyage_fortlee.conllu\Line                   30]:	 Unknown UPOS tag:	 POS	
[GUM_voyage_fortlee.conllu\Line                   584]:	 Unknown UPOS tag:	 POS	
[GUM_voyage_fortlee.conllu\Line                   761]:	 Unknown UPOS tag:	 POS	
[GUM_voyage_fortlee.conllu\Line                   874]:	 Unknown UPOS tag:	 POS	
[GUM_voyage_fortlee.conllu\Line                   992]:	 Unknown UPOS tag:	 POS	
[GUM_voyage_guadeloupe.conllu\Line                   865]:	 Unknown UPOS tag:	 POS	
[GUM_voyage_isfahan.conllu\Line                   1123]:	 Unknown UPOS tag:	 POS	
[GUM_voyage_lodz.conllu\Line                   145]:	 Unknown UPOS tag:	 POS	
[GUM_voyage_lodz.conllu\Line                   18]:	 Unknown UPOS tag:	 POS	
[GUM_voyage_lodz.conllu\Line                   212]:	 Unknown UPOS tag:	 POS	
[GUM_voyage_lodz.conllu\Line                   268]:	 Unknown UPOS tag:	 POS	
[GUM_voyage_lodz.conllu\Line                   544]:	 Unknown UPOS tag:	 POS	
[GUM_voyage_lodz.conllu\Line                   627]:	 Unknown UPOS tag:	 POS	
[GUM_voyage_lodz.conllu\Line                   654]:	 Unknown UPOS tag:	 POS	
[GUM_voyage_merida.conllu\Line                   371]:	 Unknown UPOS tag:	 POS	
[GUM_voyage_oakland.conllu\Line                   116]:	 Unknown UPOS tag:	 POS	
[GUM_voyage_oakland.conllu\Line                   1176]:	 Unknown UPOS tag:	 POS	
[GUM_voyage_oakland.conllu\Line                   124]:	 Unknown UPOS tag:	 POS	
[GUM_voyage_oakland.conllu\Line                   337]:	 Unknown UPOS tag:	 POS	
[GUM_voyage_oakland.conllu\Line                   443]:	 Unknown UPOS tag:	 POS	
[GUM_voyage_oakland.conllu\Line                   479]:	 Unknown UPOS tag:	 POS	
[GUM_voyage_oakland.conllu\Line                   607]:	 Unknown UPOS tag:	 POS	
[GUM_voyage_oakland.conllu\Line                   747]:	 Unknown UPOS tag:	 POS	
[GUM_voyage_oakland.conllu\Line                   893]:	 Unknown UPOS tag:	 POS	
[GUM_voyage_oakland.conllu\Line                   903]:	 Unknown UPOS tag:	 POS	
[GUM_voyage_phoenix.conllu\Line                   304]:	 Unknown UPOS tag:	 POS	
[GUM_voyage_phoenix.conllu\Line                   52]:	 Unknown UPOS tag:	 POS	
[GUM_voyage_socotra.conllu\Line                   1017]:	 Unknown UPOS tag:	 POS	
[GUM_voyage_socotra.conllu\Line                   1023]:	 Unknown UPOS tag:	 POS	
[GUM_voyage_socotra.conllu\Line                   1056]:	 Unknown UPOS tag:	 POS	
[GUM_voyage_socotra.conllu\Line                   966]:	 Unknown UPOS tag:	 POS	
[GUM_voyage_thailand.conllu\Line                   521]:	 Unknown UPOS tag:	 POS	
[GUM_voyage_thailand.conllu\Line                   542]:	 Unknown UPOS tag:	 POS	
[GUM_voyage_thailand.conllu\Line                   901]:	 Unknown UPOS tag:	 POS	
[GUM_voyage_tulsa.conllu\Line                   1509]:	 Unknown UPOS tag:	 POS	
[GUM_voyage_tulsa.conllu\Line                   1546]:	 Unknown UPOS tag:	 POS	
[GUM_voyage_tulsa.conllu\Line                   601]:	 Unknown UPOS tag:	 POS	
[GUM_voyage_vavau.conllu\Line                   199]:	 Unknown UPOS tag:	 POS	
[GUM_voyage_vavau.conllu\Line                   361]:	 Unknown UPOS tag:	 POS	
[GUM_voyage_york.conllu\Line                   314]:	 Unknown UPOS tag:	 POS	
[GUM_voyage_york.conllu\Line                   378]:	 Unknown UPOS tag:	 POS	
[GUM_whow_arrogant.conllu\Line                   542]:	 Unknown UPOS tag:	 POS	
[GUM_whow_basil.conllu\Line                   1220]:	 Unknown UPOS tag:	 POS	
[GUM_whow_chicken.conllu\Line                   390]:	 Unknown UPOS tag:	 POS	
[GUM_whow_chicken.conllu\Line                   602]:	 Unknown UPOS tag:	 POS	
[GUM_whow_elevator.conllu\Line                   157]:	 Unknown UPOS tag:	 POS	
[GUM_whow_flirt.conllu\Line                   1083]:	 Unknown UPOS tag:	 POS	
[GUM_whow_flirt.conllu\Line                   587]:	 Unknown UPOS tag:	 POS	
[GUM_whow_flirt.conllu\Line                   608]:	 Unknown UPOS tag:	 POS	
[GUM_whow_glowstick.conllu\Line                   335]:	 Unknown UPOS tag:	 POS	
[GUM_whow_joke.conllu\Line                   504]:	 Unknown UPOS tag:	 POS	
[GUM_whow_overalls.conllu\Line                   164]:	 Unknown UPOS tag:	 POS	
[GUM_whow_overalls.conllu\Line                   170]:	 Unknown UPOS tag:	 POS	
[GUM_whow_overalls.conllu\Line                   220]:	 Unknown UPOS tag:	 POS	
[GUM_whow_overalls.conllu\Line                   226]:	 Unknown UPOS tag:	 POS	
[GUM_whow_overalls.conllu\Line                   52]:	 Unknown UPOS tag:	 POS	
[GUM_whow_packing.conllu\Line                   458]:	 Unknown UPOS tag:	 POS	
[GUM_whow_parachute.conllu\Line                   346]:	 Unknown UPOS tag:	 POS	
[GUM_whow_quidditch.conllu\Line                   1203]:	 Unknown UPOS tag:	 POS	
[GUM_whow_quidditch.conllu\Line                   393]:	 Unknown UPOS tag:	 POS	
[GUM_whow_quinoa.conllu\Line                   312]:	 Unknown UPOS tag:	 POS	
[GUM_whow_arrogant.conllu\Line                   994]:	 Unknown UD DEPREL:	 root:	relcl
[GUM_interview_dungeon.conllu\Line                   1304]:	 Unknown UPOS tag:	 SENT	
[GUM_interview_gaming.conllu\Line                   787]:	 Unknown UD DEPREL:	 vmod	
[GUM_interview_gaming.conllu\Line                   794]:	 Unknown UD DEPREL:	 vmod	
[GUM_interview_herrick.conllu\Line                   594]:	 Unknown UD DEPREL:	 vmod	
[GUM_interview_hill.conllu\Line                   205]:	 Unknown UD DEPREL:	 vmod	
[GUM_interview_libertarian.conllu\Line                   295]:	 Unknown UD DEPREL:	 vmod	
[GUM_interview_licen.conllu\Line                   361]:	 Unknown UD DEPREL:	 vmod	
[GUM_interview_licen.conllu\Line                   404]:	 Unknown UD DEPREL:	 vmod	
[GUM_interview_mckenzie.conllu\Line                   204]:	 Unknown UD DEPREL:	 vmod	
[GUM_interview_messina.conllu\Line                   197]:	 Unknown UD DEPREL:	 vmod	
[GUM_interview_messina.conllu\Line                   903]:	 Unknown UD DEPREL:	 vmod	
[GUM_interview_messina.conllu\Line                   905]:	 Unknown UD DEPREL:	 vmod	
[GUM_interview_onion.conllu\Line                   1488]:	 Unknown UD DEPREL:	 vmod	
[GUM_interview_onion.conllu\Line                   806]:	 Unknown UD DEPREL:	 vmod	
[GUM_interview_shalev.conllu\Line                   1500]:	 Unknown UD DEPREL:	 vmod	
[GUM_news_defector.conllu\Line                   584]:	 Unknown UD DEPREL:	 vmod	
[GUM_news_election.conllu\Line                   584]:	 Unknown UD DEPREL:	 vmod	
[GUM_news_expo.conllu\Line                   421]:	 Unknown UD DEPREL:	 vmod	
[GUM_news_hackers.conllu\Line                   342]:	 Unknown UD DEPREL:	 vmod	
[GUM_news_warming.conllu\Line                   123]:	 Unknown UD DEPREL:	 vmod	
[GUM_voyage_fortlee.conllu\Line                   1159]:	 Unknown UD DEPREL:	 vmod	
[GUM_voyage_fortlee.conllu\Line                   665]:	 Unknown UD DEPREL:	 vmod	
[GUM_voyage_isfahan.conllu\Line                   1258]:	 Unknown UD DEPREL:	 vmod	
[GUM_voyage_isfahan.conllu\Line                   222]:	 Unknown UD DEPREL:	 vmod	
[GUM_voyage_isfahan.conllu\Line                   226]:	 Unknown UD DEPREL:	 vmod	
[GUM_voyage_isfahan.conllu\Line                   51]:	 Unknown UD DEPREL:	 vmod	
[GUM_voyage_isfahan.conllu\Line                   545]:	 Unknown UD DEPREL:	 vmod	
[GUM_voyage_isfahan.conllu\Line                   94]:	 Unknown UD DEPREL:	 vmod	
[GUM_voyage_merida.conllu\Line                   498]:	 Unknown UD DEPREL:	 vmod	
[GUM_voyage_oakland.conllu\Line                   1015]:	 Unknown UD DEPREL:	 vmod	
[GUM_voyage_phoenix.conllu\Line                   43]:	 Unknown UD DEPREL:	 vmod	
[GUM_voyage_vavau.conllu\Line                   88]:	 Unknown UD DEPREL:	 vmod	
[GUM_voyage_york.conllu\Line                   188]:	 Unknown UD DEPREL:	 vmod	
[GUM_voyage_york.conllu\Line                   500]:	 Unknown UD DEPREL:	 vmod	
[GUM_voyage_york.conllu\Line                   508]:	 Unknown UD DEPREL:	 vmod	
[GUM_voyage_york.conllu\Line                   515]:	 Unknown UD DEPREL:	 vmod	
[GUM_voyage_york.conllu\Line                   523]:	 Unknown UD DEPREL:	 vmod	
[GUM_whow_arrogant.conllu\Line                   843]:	 Unknown UD DEPREL:	 vmod	
[GUM_whow_chicken.conllu\Line                   297]:	 Unknown UD DEPREL:	 vmod	
[GUM_whow_cupcakes.conllu\Line                   577]:	 Unknown UD DEPREL:	 vmod	
[GUM_whow_elevator.conllu\Line                   25]:	 Unknown UD DEPREL:	 vmod	
[GUM_whow_elevator.conllu\Line                   412]:	 Unknown UD DEPREL:	 vmod	
[GUM_whow_flirt.conllu\Line                   232]:	 Unknown UD DEPREL:	 vmod	
[GUM_whow_mice.conllu\Line                   1198]:	 Unknown UD DEPREL:	 vmod	
[GUM_whow_mice.conllu\Line                   440]:	 Unknown UD DEPREL:	 vmod	
[GUM_whow_packing.conllu\Line                   764]:	 Unknown UD DEPREL:	 vmod	
[GUM_whow_procrastinating.conllu\Line                   898]:	 Unknown UD DEPREL:	 vmod	
[GUM_whow_procrastinating.conllu\Line                   960]:	 Unknown UD DEPREL:	 vmod	
[GUM_whow_quidditch.conllu\Line                   69]:	 Unknown UD DEPREL:	 vmod	
[GUM_interview_daly.conllu\Line                   1052]:	 Unknown UPOS tag:	 WRB	
[GUM_interview_daly.conllu\Line                   1058]:	 Unknown UPOS tag:	 WRB	
[GUM_interview_herrick.conllu\Line                   1032]:	 Unknown UPOS tag:	 WRB	
[GUM_interview_herrick.conllu\Line                   742]:	 Unknown UPOS tag:	 WRB	
[GUM_interview_herrick.conllu\Line                   875]:	 Unknown UPOS tag:	 WRB	
[GUM_interview_libertarian.conllu\Line                   949]:	 Unknown UPOS tag:	 WRB	
[GUM_interview_mckenzie.conllu\Line                   479]:	 Unknown UPOS tag:	 WRB	
[GUM_interview_peres.conllu\Line                   1360]:	 Unknown UPOS tag:	 WRB	
[GUM_interview_stardust.conllu\Line                   615]:	 Unknown UPOS tag:	 WRB	
[GUM_news_sensitive.conllu\Line                   383]:	 Unknown UPOS tag:	 WRB	
[GUM_voyage_chatham.conllu\Line                   1010]:	 Unknown UPOS tag:	 WRB	
[GUM_voyage_chatham.conllu\Line                   506]:	 Unknown UPOS tag:	 WRB	
[GUM_voyage_fortlee.conllu\Line                   832]:	 Unknown UPOS tag:	 WRB	
[GUM_voyage_thailand.conllu\Line                   127]:	 Unknown UPOS tag:	 WRB	
[GUM_whow_basil.conllu\Line                   397]:	 Unknown UPOS tag:	 WRB	
[GUM_whow_languages.conllu\Line                   984]:	 Unknown UPOS tag:	 WRB	
[GUM_whow_languages.conllu\Line                   988]:	 Unknown UPOS tag:	 WRB	
[GUM_whow_languages.conllu\Line                   994]:	 Unknown UPOS tag:	 WRB	
[GUM_interview_ants.conllu\Line                   1315]:	 Only the unix-style LF line terminator is allowed		
[GUM_interview_brotherhood.conllu\Line                   137]:	" DEPREL can only be ""root"" if HEAD is 0"		
[GUM_interview_brotherhood.conllu\Line                   661]:	 Only the unix-style LF line terminator is allowed		
[GUM_interview_chomsky.conllu\Line                   1322]:	 Only the unix-style LF line terminator is allowed		
[GUM_interview_cocktail.conllu\Line                   1259]:	 Only the unix-style LF line terminator is allowed		
[GUM_interview_cocktail.conllu\Line                   407]:	 Invalid UPOSTAG value (		
[GUM_interview_cocktail.conllu\Line                   412]:	 Unknown UPOS tag:		
[GUM_interview_cocktail.conllu\Line                   412]:	 Invalid UPOSTAG value		
[GUM_interview_cyclone.conllu\Line                   1100]:	 Only the unix-style LF line terminator is allowed		
[GUM_interview_cyclone.conllu\Line                   700]:	 Invalid UPOSTAG value $		
[GUM_interview_daly.conllu\Line                   1396]:	 Only the unix-style LF line terminator is allowed		
[GUM_interview_dungeon.conllu\Line                   1493]:	 Only the unix-style LF line terminator is allowed		
[GUM_interview_gaming.conllu\Line                   926]:	 Only the unix-style LF line terminator is allowed		
[GUM_interview_herrick.conllu\Line                   1663]:	 Only the unix-style LF line terminator is allowed		
[GUM_interview_herrick.conllu\Line                   389]:	 Invalid UPOSTAG value (		
[GUM_interview_hill.conllu\Line                   1092]:	 Only the unix-style LF line terminator is allowed		
[GUM_interview_libertarian.conllu\Line                   1023]:	 Only the unix-style LF line terminator is allowed		
[GUM_interview_licen.conllu\Line                   786]:	 Only the unix-style LF line terminator is allowed		
[GUM_interview_mcguire.conllu\Line                   1116]:	 Only the unix-style LF line terminator is allowed		
[GUM_interview_mckenzie.conllu\Line                   785]:	 Only the unix-style LF line terminator is allowed		
[GUM_interview_messina.conllu\Line                   15]:	 Invalid UPOSTAG value ''		
[GUM_interview_messina.conllu\Line                   1507]:	 Only the unix-style LF line terminator is allowed		
[GUM_interview_onion.conllu\Line                   1505]:	 Only the unix-style LF line terminator is allowed		
[GUM_interview_peres.conllu\Line                   1394]:	 Only the unix-style LF line terminator is allowed		
[GUM_interview_shalev.conllu\Line                   1503]:	 Only the unix-style LF line terminator is allowed		
[GUM_interview_stardust.conllu\Line                   1152]:	 Invalid UPOSTAG value ''		
[GUM_interview_stardust.conllu\Line                   1334]:	 Invalid UPOSTAG value (		
[GUM_interview_stardust.conllu\Line                   1337]:	 Unknown UPOS tag:		
[GUM_interview_stardust.conllu\Line                   1337]:	 Invalid UPOSTAG value		
[GUM_interview_stardust.conllu\Line                   1346]:	 Only the unix-style LF line terminator is allowed		
[GUM_news_asylum.conllu\Line                   432]:	 Only the unix-style LF line terminator is allowed		
[GUM_news_clock.conllu\Line                   808]:	 Only the unix-style LF line terminator is allowed		
[GUM_news_crane.conllu\Line                   336]:	 Only the unix-style LF line terminator is allowed		
[GUM_news_defector.conllu\Line                   1038]:	 Only the unix-style LF line terminator is allowed		
[GUM_news_defector.conllu\Line                   165]:	 Invalid UPOSTAG value $		
[GUM_news_election.conllu\Line                   1196]:	 Only the unix-style LF line terminator is allowed		
[GUM_news_expo.conllu\Line                   432]:	 Invalid UPOSTAG value $		
[GUM_news_expo.conllu\Line                   972]:	 Only the unix-style LF line terminator is allowed		
[GUM_news_flag.conllu\Line                   492]:	 Only the unix-style LF line terminator is allowed		
[GUM_news_hackers.conllu\Line                   791]:	 Only the unix-style LF line terminator is allowed		
[GUM_news_homeopathic.conllu\Line                   734]:	 Only the unix-style LF line terminator is allowed		
[GUM_news_ie9.conllu\Line                   572]:	 Only the unix-style LF line terminator is allowed		
[GUM_news_imprisoned.conllu\Line                   546]:	 Only the unix-style LF line terminator is allowed		
[GUM_news_iodine.conllu\Line                   1232]:	 Only the unix-style LF line terminator is allowed		
[GUM_news_iodine.conllu\Line                   192]:	 Invalid UPOSTAG value :		
[GUM_news_korea.conllu\Line                   481]:	 Only the unix-style LF line terminator is allowed		
[GUM_news_lanterns.conllu\Line                   675]:	 Only the unix-style LF line terminator is allowed		
[GUM_news_nasa.conllu\Line                   1441]:	 Only the unix-style LF line terminator is allowed		
[GUM_news_sensitive.conllu\Line                   756]:	 Only the unix-style LF line terminator is allowed		
[GUM_news_stampede.conllu\Line                   295]:	 Only the unix-style LF line terminator is allowed		
[GUM_news_taxes.conllu\Line                   756]:	 Only the unix-style LF line terminator is allowed		
[GUM_news_warhol.conllu\Line                   2212]:	 Only the unix-style LF line terminator is allowed		
[GUM_news_warhol.conllu\Line                   503]:	 Invalid UPOSTAG value :		
[GUM_news_warming.conllu\Line                   65]:	 Invalid UPOSTAG value :		
[GUM_news_warming.conllu\Line                   715]:	 Only the unix-style LF line terminator is allowed		
[GUM_news_worship.conllu\Line                   202]:	 Only the unix-style LF line terminator is allowed		
[GUM_voyage_athens.conllu\Line                   1182]:	 Only the unix-style LF line terminator is allowed		
[GUM_voyage_chatham.conllu\Line                   1361]:	 Only the unix-style LF line terminator is allowed		
[GUM_voyage_cleveland.conllu\Line                   718]:	 Only the unix-style LF line terminator is allowed		
[GUM_voyage_coron.conllu\Line                   703]:	 Only the unix-style LF line terminator is allowed		
[GUM_voyage_cuba.conllu\Line                   951]:	 Only the unix-style LF line terminator is allowed		
[GUM_voyage_fortlee.conllu\Line                   1208]:	 Invalid UPOSTAG value :		
[GUM_voyage_fortlee.conllu\Line                   1215]:	 Invalid UPOSTAG value :		
[GUM_voyage_fortlee.conllu\Line                   1222]:	 Invalid UPOSTAG value :		
[GUM_voyage_fortlee.conllu\Line                   1379]:	 Only the unix-style LF line terminator is allowed		
[GUM_voyage_guadeloupe.conllu\Line                   771]:	 Invalid UPOSTAG value :		
[GUM_voyage_guadeloupe.conllu\Line                   787]:	 Invalid UPOSTAG value :		
[GUM_voyage_guadeloupe.conllu\Line                   961]:	 Only the unix-style LF line terminator is allowed		
[GUM_voyage_isfahan.conllu\Line                   1276]:	 Only the unix-style LF line terminator is allowed		
[GUM_voyage_lodz.conllu\Line                   1011]:	 Only the unix-style LF line terminator is allowed		
[GUM_voyage_merida.conllu\Line                   722]:	 Invalid UPOSTAG value :		
[GUM_voyage_merida.conllu\Line                   727]:	 Invalid UPOSTAG value :		
[GUM_voyage_merida.conllu\Line                   767]:	 Invalid UPOSTAG value :		
[GUM_voyage_merida.conllu\Line                   770]:	 Only the unix-style LF line terminator is allowed		
[GUM_voyage_oakland.conllu\Line                   1228]:	 Only the unix-style LF line terminator is allowed		
[GUM_voyage_phoenix.conllu\Line                   1070]:	 Only the unix-style LF line terminator is allowed		
[GUM_voyage_socotra.conllu\Line                   1113]:	 Only the unix-style LF line terminator is allowed		
[GUM_voyage_thailand.conllu\Line                   1103]:	 Only the unix-style LF line terminator is allowed		
[GUM_voyage_tulsa.conllu\Line                   1606]:	 Only the unix-style LF line terminator is allowed		
[GUM_voyage_vavau.conllu\Line                   778]:	 Only the unix-style LF line terminator is allowed		
[GUM_voyage_york.conllu\Line                   850]:	 Only the unix-style LF line terminator is allowed		
[GUM_whow_arrogant.conllu\Line                   1353]:	 Only the unix-style LF line terminator is allowed		
[GUM_whow_arrogant.conllu\Line                   999]:	" DEPREL must be ""root"" if HEAD is 0"		
[GUM_whow_ballet.conllu\Line                   235]:	 Invalid UPOSTAG value :		
[GUM_whow_ballet.conllu\Line                   840]:	 Only the unix-style LF line terminator is allowed		
[GUM_whow_basil.conllu\Line                   1469]:	 Only the unix-style LF line terminator is allowed		
[GUM_whow_cactus.conllu\Line                   818]:	 Only the unix-style LF line terminator is allowed		
[GUM_whow_chicken.conllu\Line                   845]:	 Only the unix-style LF line terminator is allowed		
[GUM_whow_cupcakes.conllu\Line                   1312]:	 Only the unix-style LF line terminator is allowed		
[GUM_whow_cupcakes.conllu\Line                   263]:	 Invalid UPOSTAG value :		
[GUM_whow_cupcakes.conllu\Line                   331]:	 Invalid UPOSTAG value :		
[GUM_whow_cupcakes.conllu\Line                   358]:	 Invalid UPOSTAG value :		
[GUM_whow_cupcakes.conllu\Line                   374]:	 Invalid UPOSTAG value :		
[GUM_whow_cupcakes.conllu\Line                   669]:	 Invalid UPOSTAG value :		
[GUM_whow_elevator.conllu\Line                   877]:	 Only the unix-style LF line terminator is allowed		
[GUM_whow_flirt.conllu\Line                   1319]:	 Only the unix-style LF line terminator is allowed		
[GUM_whow_glowstick.conllu\Line                   873]:	 Only the unix-style LF line terminator is allowed		
[GUM_whow_joke.conllu\Line                   1262]:	 Only the unix-style LF line terminator is allowed		
[GUM_whow_languages.conllu\Line                   1437]:	 Only the unix-style LF line terminator is allowed		
[GUM_whow_mice.conllu\Line                   1255]:	 Only the unix-style LF line terminator is allowed		
[GUM_whow_overalls.conllu\Line                   816]:	 Only the unix-style LF line terminator is allowed		
[GUM_whow_packing.conllu\Line                   914]:	 Only the unix-style LF line terminator is allowed		
[GUM_whow_parachute.conllu\Line                   1090]:	 Only the unix-style LF line terminator is allowed		
[GUM_whow_procrastinating.conllu\Line                   1000]:	 Unknown UPOS tag:		
[GUM_whow_procrastinating.conllu\Line                   1000]:	 Invalid UPOSTAG value		
[GUM_whow_procrastinating.conllu\Line                   1111]:	 Only the unix-style LF line terminator is allowed		
[GUM_whow_procrastinating.conllu\Line                   750]:	 Invalid UPOSTAG value (		
[GUM_whow_procrastinating.conllu\Line                   752]:	 Unknown UPOS tag:		
[GUM_whow_procrastinating.conllu\Line                   752]:	 Invalid UPOSTAG value		
[GUM_whow_procrastinating.conllu\Line                   998]:	 Invalid UPOSTAG value (		
[GUM_whow_quidditch.conllu\Line                   1399]:	 Only the unix-style LF line terminator is allowed		
[GUM_whow_quinoa.conllu\Line                   1106]:	 Only the unix-style LF line terminator is allowed		
[GUM_whow_skittles.conllu\Line                   1223]:	 Only the unix-style LF line terminator is allowed		
[GUM_whow_skittles.conllu\Line                   466]:	 Invalid UPOSTAG value :		
GUM_interview_ants.conllu\			
GUM_interview_ants.conllu\*** FAILED *** with 3 errors			
GUM_interview_ants.conllu\Format errors:	1		
GUM_interview_ants.conllu\Syntax errors:	2		
GUM_interview_brotherhood.conllu\			
GUM_interview_brotherhood.conllu\*** FAILED *** with 2 errors			
GUM_interview_brotherhood.conllu\Format errors:	1		
GUM_interview_brotherhood.conllu\Syntax errors:	1		
GUM_interview_chomsky.conllu\			
GUM_interview_chomsky.conllu\*** FAILED *** with 14 errors			
GUM_interview_chomsky.conllu\Format errors:	1		
GUM_interview_chomsky.conllu\Morpho errors:	2		
GUM_interview_chomsky.conllu\Syntax errors:	11		
GUM_interview_cocktail.conllu\			
GUM_interview_cocktail.conllu\*** FAILED *** with 12 errors			
GUM_interview_cocktail.conllu\Format errors:	1		
GUM_interview_cocktail.conllu\Morpho errors:	10		
GUM_interview_cocktail.conllu\Syntax errors:	1		
GUM_interview_cyclone.conllu\			
GUM_interview_cyclone.conllu\*** FAILED *** with 9 errors			
GUM_interview_cyclone.conllu\Format errors:	1		
GUM_interview_cyclone.conllu\Morpho errors:	3		
GUM_interview_cyclone.conllu\Syntax errors:	5		
GUM_interview_daly.conllu\			
GUM_interview_daly.conllu\*** FAILED *** with 6 errors			
GUM_interview_daly.conllu\Format errors:	1		
GUM_interview_daly.conllu\Morpho errors:	4		
GUM_interview_daly.conllu\Syntax errors:	1		
GUM_interview_dungeon.conllu\			
GUM_interview_dungeon.conllu\*** FAILED *** with 10 errors			
GUM_interview_dungeon.conllu\Format errors:	1		
GUM_interview_dungeon.conllu\Morpho errors:	3		
GUM_interview_dungeon.conllu\Syntax errors:	6		
GUM_interview_gaming.conllu\			
GUM_interview_gaming.conllu\*** FAILED *** with 6 errors			
GUM_interview_gaming.conllu\Format errors:	1		
GUM_interview_gaming.conllu\Morpho errors:	1		
GUM_interview_gaming.conllu\Syntax errors:	4		
GUM_interview_herrick.conllu\			
GUM_interview_herrick.conllu\*** FAILED *** with 19 errors			
GUM_interview_herrick.conllu\Format errors:	1		
GUM_interview_herrick.conllu\Morpho errors:	11		
GUM_interview_herrick.conllu\Syntax errors:	7		
GUM_interview_hill.conllu\			
GUM_interview_hill.conllu\*** FAILED *** with 2 errors			
GUM_interview_hill.conllu\Format errors:	1		
GUM_interview_hill.conllu\Syntax errors:	1		
GUM_interview_libertarian.conllu\			
GUM_interview_libertarian.conllu\*** FAILED *** with 9 errors			
GUM_interview_libertarian.conllu\Format errors:	1		
GUM_interview_libertarian.conllu\Morpho errors:	6		
GUM_interview_libertarian.conllu\Syntax errors:	2		
GUM_interview_licen.conllu\			
GUM_interview_licen.conllu\*** FAILED *** with 7 errors			
GUM_interview_licen.conllu\Format errors:	1		
GUM_interview_licen.conllu\Morpho errors:	1		
GUM_interview_licen.conllu\Syntax errors:	5		
GUM_interview_mcguire.conllu\			
GUM_interview_mcguire.conllu\*** FAILED *** with 10 errors			
GUM_interview_mcguire.conllu\Format errors:	1		
GUM_interview_mcguire.conllu\Morpho errors:	5		
GUM_interview_mcguire.conllu\Syntax errors:	4		
GUM_interview_mckenzie.conllu\			
GUM_interview_mckenzie.conllu\*** FAILED *** with 5 errors			
GUM_interview_mckenzie.conllu\Format errors:	1		
GUM_interview_mckenzie.conllu\Morpho errors:	3		
GUM_interview_mckenzie.conllu\Syntax errors:	1		
GUM_interview_messina.conllu\			
GUM_interview_messina.conllu\*** FAILED *** with 11 errors			
GUM_interview_messina.conllu\Format errors:	1		
GUM_interview_messina.conllu\Morpho errors:	3		
GUM_interview_messina.conllu\Syntax errors:	7		
GUM_interview_onion.conllu\			
GUM_interview_onion.conllu\*** FAILED *** with 11 errors			
GUM_interview_onion.conllu\Format errors:	1		
GUM_interview_onion.conllu\Morpho errors:	4		
GUM_interview_onion.conllu\Syntax errors:	6		
GUM_interview_peres.conllu\			
GUM_interview_peres.conllu\*** FAILED *** with 7 errors			
GUM_interview_peres.conllu\Format errors:	1		
GUM_interview_peres.conllu\Morpho errors:	5		
GUM_interview_peres.conllu\Syntax errors:	1		
GUM_interview_shalev.conllu\			
GUM_interview_shalev.conllu\*** FAILED *** with 8 errors			
GUM_interview_shalev.conllu\Format errors:	1		
GUM_interview_shalev.conllu\Morpho errors:	1		
GUM_interview_shalev.conllu\Syntax errors:	6		
GUM_interview_stardust.conllu\			
GUM_interview_stardust.conllu\*** FAILED *** with 14 errors			
GUM_interview_stardust.conllu\Format errors:	1		
GUM_interview_stardust.conllu\Morpho errors:	10		
GUM_interview_stardust.conllu\Syntax errors:	3		
GUM_news_asylum.conllu\			
GUM_news_asylum.conllu\*** FAILED *** with 6 errors			
GUM_news_asylum.conllu\Format errors:	1		
GUM_news_asylum.conllu\Morpho errors:	3		
GUM_news_asylum.conllu\Syntax errors:	2		
GUM_news_clock.conllu\			
GUM_news_clock.conllu\*** FAILED *** with 5 errors			
GUM_news_clock.conllu\Format errors:	1		
GUM_news_clock.conllu\Morpho errors:	3		
GUM_news_clock.conllu\Syntax errors:	1		
GUM_news_crane.conllu\			
GUM_news_crane.conllu\*** FAILED *** with 9 errors			
GUM_news_crane.conllu\Format errors:	1		
GUM_news_crane.conllu\Morpho errors:	6		
GUM_news_crane.conllu\Syntax errors:	2		
GUM_news_defector.conllu\			
GUM_news_defector.conllu\*** FAILED *** with 10 errors			
GUM_news_defector.conllu\Format errors:	1		
GUM_news_defector.conllu\Morpho errors:	6		
GUM_news_defector.conllu\Syntax errors:	3		
GUM_news_election.conllu\			
GUM_news_election.conllu\*** FAILED *** with 26 errors			
GUM_news_election.conllu\...suppressing further errors regarding Morpho			
GUM_news_election.conllu\Format errors:	1		
GUM_news_election.conllu\Morpho errors:	23		
GUM_news_election.conllu\Syntax errors:	2		
GUM_news_expo.conllu\			
GUM_news_expo.conllu\*** FAILED *** with 9 errors			
GUM_news_expo.conllu\Format errors:	1		
GUM_news_expo.conllu\Morpho errors:	5		
GUM_news_expo.conllu\Syntax errors:	3		
GUM_news_flag.conllu\			
GUM_news_flag.conllu\*** FAILED *** with 7 errors			
GUM_news_flag.conllu\Format errors:	1		
GUM_news_flag.conllu\Morpho errors:	6		
GUM_news_hackers.conllu\			
GUM_news_hackers.conllu\*** FAILED *** with 13 errors			
GUM_news_hackers.conllu\Format errors:	1		
GUM_news_hackers.conllu\Morpho errors:	7		
GUM_news_hackers.conllu\Syntax errors:	5		
GUM_news_homeopathic.conllu\			
GUM_news_homeopathic.conllu\*** FAILED *** with 13 errors			
GUM_news_homeopathic.conllu\Format errors:	1		
GUM_news_homeopathic.conllu\Morpho errors:	8		
GUM_news_homeopathic.conllu\Syntax errors:	4		
GUM_news_ie9.conllu\			
GUM_news_ie9.conllu\*** FAILED *** with 7 errors			
GUM_news_ie9.conllu\Format errors:	1		
GUM_news_ie9.conllu\Morpho errors:	6		
GUM_news_imprisoned.conllu\			
GUM_news_imprisoned.conllu\*** FAILED *** with 6 errors			
GUM_news_imprisoned.conllu\Format errors:	1		
GUM_news_imprisoned.conllu\Morpho errors:	4		
GUM_news_imprisoned.conllu\Syntax errors:	1		
GUM_news_iodine.conllu\			
GUM_news_iodine.conllu\*** FAILED *** with 9 errors			
GUM_news_iodine.conllu\Format errors:	1		
GUM_news_iodine.conllu\Morpho errors:	6		
GUM_news_iodine.conllu\Syntax errors:	2		
GUM_news_korea.conllu\			
GUM_news_korea.conllu\*** FAILED *** with 8 errors			
GUM_news_korea.conllu\Format errors:	1		
GUM_news_korea.conllu\Morpho errors:	5		
GUM_news_korea.conllu\Syntax errors:	2		
GUM_news_lanterns.conllu\			
GUM_news_lanterns.conllu\*** FAILED *** with 4 errors			
GUM_news_lanterns.conllu\Format errors:	1		
GUM_news_lanterns.conllu\Syntax errors:	3		
GUM_news_nasa.conllu\			
GUM_news_nasa.conllu\*** FAILED *** with 12 errors			
GUM_news_nasa.conllu\Format errors:	1		
GUM_news_nasa.conllu\Morpho errors:	11		
GUM_news_sensitive.conllu\			
GUM_news_sensitive.conllu\*** FAILED *** with 6 errors			
GUM_news_sensitive.conllu\Format errors:	1		
GUM_news_sensitive.conllu\Morpho errors:	3		
GUM_news_sensitive.conllu\Syntax errors:	2		
GUM_news_stampede.conllu\			
GUM_news_stampede.conllu\*** FAILED *** with 4 errors			
GUM_news_stampede.conllu\Format errors:	1		
GUM_news_stampede.conllu\Morpho errors:	1		
GUM_news_stampede.conllu\Syntax errors:	2		
GUM_news_taxes.conllu\			
GUM_news_taxes.conllu\*** FAILED *** with 4 errors			
GUM_news_taxes.conllu\Format errors:	1		
GUM_news_taxes.conllu\Morpho errors:	1		
GUM_news_taxes.conllu\Syntax errors:	2		
GUM_news_warhol.conllu\			
GUM_news_warhol.conllu\*** FAILED *** with 28 errors			
GUM_news_warhol.conllu\...suppressing further errors regarding Morpho			
GUM_news_warhol.conllu\Format errors:	1		
GUM_news_warhol.conllu\Morpho errors:	21		
GUM_news_warhol.conllu\Syntax errors:	6		
GUM_news_warming.conllu\			
GUM_news_warming.conllu\*** FAILED *** with 10 errors			
GUM_news_warming.conllu\Format errors:	1		
GUM_news_warming.conllu\Morpho errors:	2		
GUM_news_warming.conllu\Syntax errors:	7		
GUM_news_worship.conllu\			
GUM_news_worship.conllu\*** FAILED *** with 4 errors			
GUM_news_worship.conllu\Format errors:	1		
GUM_news_worship.conllu\Syntax errors:	3		
GUM_voyage_athens.conllu\			
GUM_voyage_athens.conllu\*** FAILED *** with 15 errors			
GUM_voyage_athens.conllu\Format errors:	1		
GUM_voyage_athens.conllu\Morpho errors:	13		
GUM_voyage_athens.conllu\Syntax errors:	1		
GUM_voyage_chatham.conllu\			
GUM_voyage_chatham.conllu\*** FAILED *** with 9 errors			
GUM_voyage_chatham.conllu\Format errors:	1		
GUM_voyage_chatham.conllu\Morpho errors:	5		
GUM_voyage_chatham.conllu\Syntax errors:	3		
GUM_voyage_cleveland.conllu\			
GUM_voyage_cleveland.conllu\*** FAILED *** with 4 errors			
GUM_voyage_cleveland.conllu\Format errors:	1		
GUM_voyage_cleveland.conllu\Morpho errors:	2		
GUM_voyage_cleveland.conllu\Syntax errors:	1		
GUM_voyage_coron.conllu\			
GUM_voyage_coron.conllu\*** FAILED *** with 2 errors			
GUM_voyage_coron.conllu\Format errors:	1		
GUM_voyage_coron.conllu\Syntax errors:	1		
GUM_voyage_cuba.conllu\			
GUM_voyage_cuba.conllu\*** FAILED *** with 6 errors			
GUM_voyage_cuba.conllu\Format errors:	1		
GUM_voyage_cuba.conllu\Syntax errors:	5		
GUM_voyage_fortlee.conllu\			
GUM_voyage_fortlee.conllu\*** FAILED *** with 24 errors			
GUM_voyage_fortlee.conllu\Format errors:	1		
GUM_voyage_fortlee.conllu\Morpho errors:	14		
GUM_voyage_fortlee.conllu\Syntax errors:	9		
GUM_voyage_guadeloupe.conllu\			
GUM_voyage_guadeloupe.conllu\*** FAILED *** with 10 errors			
GUM_voyage_guadeloupe.conllu\Format errors:	1		
GUM_voyage_guadeloupe.conllu\Morpho errors:	5		
GUM_voyage_guadeloupe.conllu\Syntax errors:	4		
GUM_voyage_isfahan.conllu\			
GUM_voyage_isfahan.conllu\*** FAILED *** with 11 errors			
GUM_voyage_isfahan.conllu\Format errors:	1		
GUM_voyage_isfahan.conllu\Morpho errors:	1		
GUM_voyage_isfahan.conllu\Syntax errors:	9		
GUM_voyage_lodz.conllu\			
GUM_voyage_lodz.conllu\*** FAILED *** with 9 errors			
GUM_voyage_lodz.conllu\Format errors:	1		
GUM_voyage_lodz.conllu\Morpho errors:	7		
GUM_voyage_lodz.conllu\Syntax errors:	1		
GUM_voyage_merida.conllu\			
GUM_voyage_merida.conllu\*** FAILED *** with 12 errors			
GUM_voyage_merida.conllu\Format errors:	1		
GUM_voyage_merida.conllu\Morpho errors:	7		
GUM_voyage_merida.conllu\Syntax errors:	4		
GUM_voyage_oakland.conllu\			
GUM_voyage_oakland.conllu\*** FAILED *** with 13 errors			
GUM_voyage_oakland.conllu\Format errors:	1		
GUM_voyage_oakland.conllu\Morpho errors:	10		
GUM_voyage_oakland.conllu\Syntax errors:	2		
GUM_voyage_phoenix.conllu\			
GUM_voyage_phoenix.conllu\*** FAILED *** with 10 errors			
GUM_voyage_phoenix.conllu\Format errors:	1		
GUM_voyage_phoenix.conllu\Morpho errors:	2		
GUM_voyage_phoenix.conllu\Syntax errors:	7		
GUM_voyage_socotra.conllu\			
GUM_voyage_socotra.conllu\*** FAILED *** with 8 errors			
GUM_voyage_socotra.conllu\Format errors:	1		
GUM_voyage_socotra.conllu\Morpho errors:	4		
GUM_voyage_socotra.conllu\Syntax errors:	3		
GUM_voyage_thailand.conllu\			
GUM_voyage_thailand.conllu\*** FAILED *** with 8 errors			
GUM_voyage_thailand.conllu\Format errors:	1		
GUM_voyage_thailand.conllu\Morpho errors:	4		
GUM_voyage_thailand.conllu\Syntax errors:	3		
GUM_voyage_tulsa.conllu\			
GUM_voyage_tulsa.conllu\*** FAILED *** with 15 errors			
GUM_voyage_tulsa.conllu\Format errors:	1		
GUM_voyage_tulsa.conllu\Morpho errors:	3		
GUM_voyage_tulsa.conllu\Syntax errors:	11		
GUM_voyage_vavau.conllu\			
GUM_voyage_vavau.conllu\*** FAILED *** with 5 errors			
GUM_voyage_vavau.conllu\Format errors:	1		
GUM_voyage_vavau.conllu\Morpho errors:	2		
GUM_voyage_vavau.conllu\Syntax errors:	2		
GUM_voyage_york.conllu\			
GUM_voyage_york.conllu\*** FAILED *** with 11 errors			
GUM_voyage_york.conllu\Format errors:	1		
GUM_voyage_york.conllu\Morpho errors:	2		
GUM_voyage_york.conllu\Syntax errors:	8		
GUM_whow_arrogant.conllu\			
GUM_whow_arrogant.conllu\*** FAILED *** with 9 errors			
GUM_whow_arrogant.conllu\Format errors:	1		
GUM_whow_arrogant.conllu\Morpho errors:	2		
GUM_whow_arrogant.conllu\Syntax errors:	6		
GUM_whow_ballet.conllu\			
GUM_whow_ballet.conllu\*** FAILED *** with 5 errors			
GUM_whow_ballet.conllu\Format errors:	1		
GUM_whow_ballet.conllu\Morpho errors:	2		
GUM_whow_ballet.conllu\Syntax errors:	2		
GUM_whow_basil.conllu\			
GUM_whow_basil.conllu\*** FAILED *** with 5 errors			
GUM_whow_basil.conllu\Format errors:	1		
GUM_whow_basil.conllu\Morpho errors:	2		
GUM_whow_basil.conllu\Syntax errors:	2		
GUM_whow_cactus.conllu\			
GUM_whow_cactus.conllu\*** FAILED *** with 4 errors			
GUM_whow_cactus.conllu\Format errors:	1		
GUM_whow_cactus.conllu\Syntax errors:	3		
GUM_whow_chicken.conllu\			
GUM_whow_chicken.conllu\*** FAILED *** with 6 errors			
GUM_whow_chicken.conllu\Format errors:	1		
GUM_whow_chicken.conllu\Morpho errors:	2		
GUM_whow_chicken.conllu\Syntax errors:	3		
GUM_whow_cupcakes.conllu\			
GUM_whow_cupcakes.conllu\*** FAILED *** with 12 errors			
GUM_whow_cupcakes.conllu\Format errors:	1		
GUM_whow_cupcakes.conllu\Morpho errors:	10		
GUM_whow_cupcakes.conllu\Syntax errors:	1		
GUM_whow_elevator.conllu\			
GUM_whow_elevator.conllu\*** FAILED *** with 8 errors			
GUM_whow_elevator.conllu\Format errors:	1		
GUM_whow_elevator.conllu\Morpho errors:	2		
GUM_whow_elevator.conllu\Syntax errors:	5		
GUM_whow_flirt.conllu\			
GUM_whow_flirt.conllu\*** FAILED *** with 9 errors			
GUM_whow_flirt.conllu\Format errors:	1		
GUM_whow_flirt.conllu\Morpho errors:	3		
GUM_whow_flirt.conllu\Syntax errors:	5		
GUM_whow_glowstick.conllu\			
GUM_whow_glowstick.conllu\*** FAILED *** with 4 errors			
GUM_whow_glowstick.conllu\Format errors:	1		
GUM_whow_glowstick.conllu\Morpho errors:	1		
GUM_whow_glowstick.conllu\Syntax errors:	2		
GUM_whow_joke.conllu\			
GUM_whow_joke.conllu\*** FAILED *** with 4 errors			
GUM_whow_joke.conllu\Format errors:	1		
GUM_whow_joke.conllu\Morpho errors:	1		
GUM_whow_joke.conllu\Syntax errors:	2		
GUM_whow_languages.conllu\			
GUM_whow_languages.conllu\*** FAILED *** with 9 errors			
GUM_whow_languages.conllu\Format errors:	1		
GUM_whow_languages.conllu\Morpho errors:	5		
GUM_whow_languages.conllu\Syntax errors:	3		
GUM_whow_mice.conllu\			
GUM_whow_mice.conllu\*** FAILED *** with 7 errors			
GUM_whow_mice.conllu\Format errors:	1		
GUM_whow_mice.conllu\Syntax errors:	6		
GUM_whow_overalls.conllu\			
GUM_whow_overalls.conllu\*** FAILED *** with 8 errors			
GUM_whow_overalls.conllu\Format errors:	1		
GUM_whow_overalls.conllu\Morpho errors:	6		
GUM_whow_overalls.conllu\Syntax errors:	1		
GUM_whow_packing.conllu\			
GUM_whow_packing.conllu\*** FAILED *** with 6 errors			
GUM_whow_packing.conllu\Format errors:	1		
GUM_whow_packing.conllu\Morpho errors:	1		
GUM_whow_packing.conllu\Syntax errors:	4		
GUM_whow_parachute.conllu\			
GUM_whow_parachute.conllu\*** FAILED *** with 5 errors			
GUM_whow_parachute.conllu\Format errors:	1		
GUM_whow_parachute.conllu\Morpho errors:	2		
GUM_whow_parachute.conllu\Syntax errors:	2		
GUM_whow_procrastinating.conllu\			
GUM_whow_procrastinating.conllu\*** FAILED *** with 20 errors			
GUM_whow_procrastinating.conllu\Format errors:	1		
GUM_whow_procrastinating.conllu\Morpho errors:	8		
GUM_whow_procrastinating.conllu\Syntax errors:	11		
GUM_whow_quidditch.conllu\			
GUM_whow_quidditch.conllu\*** FAILED *** with 9 errors			
GUM_whow_quidditch.conllu\Format errors:	1		
GUM_whow_quidditch.conllu\Morpho errors:	2		
GUM_whow_quidditch.conllu\Syntax errors:	6		
GUM_whow_quinoa.conllu\			
GUM_whow_quinoa.conllu\*** FAILED *** with 4 errors			
GUM_whow_quinoa.conllu\Format errors:	1		
GUM_whow_quinoa.conllu\Morpho errors:	1		
GUM_whow_quinoa.conllu\Syntax errors:	2		
GUM_whow_skittles.conllu\*** FAILED *** with 5 errors			
GUM_whow_skittles.conllu\Format errors:	1		
GUM_whow_skittles.conllu\Morpho errors:	2		
GUM_whow_skittles.conllu\Syntax errors:	2		
